1111111111111
1000PCE000001
1111111111111